//MAP CONVERTED BY dmm2tgm.py THIS HEADER COMMENT PREVENTS RECONVERSION, DO NOT REMOVE
"a" = (
/turf/open/floor/rogue/tile/brick,
/area/template_noop)
"f" = (
/turf/closed/wall/mineral/rogue/stonebrick,
/area/template_noop)
"g" = (
/obj/item/clothing/ring/gold,
/turf/open/floor/rogue/tile/brick,
/area/template_noop)

(1,1,1) = {"
a
a
a
a
a
a
"}
(2,1,1) = {"
a
f
a
a
f
a
"}
(3,1,1) = {"
g
a
a
a
g
a
"}
(4,1,1) = {"
a
a
a
a
a
a
"}
(5,1,1) = {"
a
f
g
a
f
a
"}
(6,1,1) = {"
a
a
a
a
a
a
"}
