//MAP CONVERTED BY dmm2tgm.py THIS HEADER COMMENT PREVENTS RECONVERSION, DO NOT REMOVE
"a" = (
/turf/open/floor/rogue/dirt,
/area/rogue)
"r" = (
/obj/effect/decal/cleanable/dirt,
/turf/closed/wall/mineral/rogue/stonebrick,
/area/rogue)
"u" = (
/obj/effect/decal/cleanable/dirt,
/turf/closed/mineral/rogue,
/area/rogue)
"v" = (
/obj/effect/decal/cleanable/dirt,
/turf/open/floor/rogue/dirt,
/area/rogue)
"z" = (
/turf/open/floor/rogue/naturalstone,
/area/rogue)
"A" = (
/turf/closed/wall/mineral/rogue/stonebrick,
/area/rogue)
"D" = (
/turf/closed/mineral/rogue,
/area/rogue)
"H" = (
/obj/effect/decal/cleanable/dirt,
/turf/open/floor/rogue/naturalstone,
/area/rogue)
"J" = (
/turf/open/floor/rogue/dirt/road,
/area/rogue)
"R" = (
/obj/effect/decal/cleanable/dirt,
/turf/open/floor/rogue/dirt/road,
/area/rogue)
"X" = (
/obj/structure/bed/rogue/shit,
/mob/living/carbon/human/species/goblin/npc,
/turf/open/floor/rogue/naturalstone,
/area/rogue)

(1,1,1) = {"
A
u
J
a
J
r
"}
(2,1,1) = {"
R
D
D
u
v
J
"}
(3,1,1) = {"
z
D
D
D
D
J
"}
(4,1,1) = {"
J
v
A
D
X
a
"}
(5,1,1) = {"
A
z
H
u
a
a
"}
(6,1,1) = {"
A
r
z
z
H
z
"}
