//MAP CONVERTED BY dmm2tgm.py THIS HEADER COMMENT PREVENTS RECONVERSION, DO NOT REMOVE
"a" = (
/obj/effect/decal/cleanable/dirt,
/turf/open/floor/rogue/dirt,
/area/rogue)
"h" = (
/obj/effect/decal/cleanable/dirt,
/turf/open/floor/rogue/naturalstone,
/area/rogue)
"n" = (
/turf/open/floor/rogue/dirt/road,
/area/rogue)
"q" = (
/turf/open/floor/rogue/dirt,
/area/rogue)
"r" = (
/turf/closed/wall/mineral/rogue/stonebrick,
/area/rogue)
"O" = (
/turf/open/floor/rogue/naturalstone,
/area/rogue)
"W" = (
/turf/closed/mineral/rogue,
/area/rogue)
"Y" = (
/obj/effect/decal/cleanable/dirt,
/turf/closed/mineral/rogue,
/area/rogue)

(1,1,1) = {"
r
Y
n
q
n
Y
"}
(2,1,1) = {"
Y
W
W
a
Y
n
"}
(3,1,1) = {"
O
W
q
q
W
O
"}
(4,1,1) = {"
n
a
q
O
O
q
"}
(5,1,1) = {"
W
W
h
Y
W
W
"}
(6,1,1) = {"
r
Y
O
O
Y
r
"}
