//MAP CONVERTED BY dmm2tgm.py THIS HEADER COMMENT PREVENTS RECONVERSION, DO NOT REMOVE
"a" = (
/turf/open/floor/rogue/tile/brick,
/area/template_noop)
"b" = (
/turf/open/floor/rogue/dirt/road,
/area/template_noop)
"c" = (
/obj/structure/table/wood,
/obj/item/reagent_containers/glass/bowl,
/obj/item/kitchen/ironfork{
	pixel_y = 3;
	pixel_x = 8
	},
/turf/open/floor/rogue/tile/brick,
/area/template_noop)
"d" = (
/obj/structure/rack/rogue/shelf/big{
	pixel_x = 31
	},
/obj/item/reagent_containers/glass/cup/wooden{
	pixel_x = 34;
	pixel_y = 18
	},
/turf/open/floor/rogue/tile/brick,
/area/template_noop)
"f" = (
/obj/structure/closet/crate/chest/neu,
/turf/open/floor/rogue/tile/brick,
/area/template_noop)
"j" = (
/obj/structure/bookcase/random/adult,
/turf/open/floor/rogue/tile/brick,
/area/template_noop)
"k" = (
/obj/structure/bookcase/random,
/turf/open/floor/rogue/tile/brick,
/area/template_noop)
"l" = (
/obj/random/mob/skeleton,
/turf/open/floor/rogue/tile/brick,
/area/template_noop)
"n" = (
/obj/structure/bed/rogue,
/obj/item/dildo/gold{
	pixel_y = 9;
	pixel_x = 6
	},
/obj/effect/decal/cleanable/blood/drip{
	dir = 1;
	icon_state = "pool5"
	},
/obj/effect/decal/cleanable/blood/drip{
	dir = 1;
	icon_state = "itemblood"
	},
/turf/open/floor/rogue/tile/brick,
/area/template_noop)
"o" = (
/turf/closed/wall/mineral/rogue/wooddark/vertical,
/area/template_noop)
"q" = (
/obj/structure/mineral_door/wood/deadbolt,
/turf/open/floor/rogue/tile/brick,
/area/template_noop)
"u" = (
/obj/effect/decal/cleanable/blood/drip{
	dir = 1
	},
/obj/effect/decal/cleanable/blood/drip{
	dir = 1;
	icon_state = "pool3"
	},
/turf/open/floor/rogue/tile/brick,
/area/template_noop)
"x" = (
/obj/machinery/light/rogue/torchholder/r,
/obj/effect/decal/cleanable/blood/drip{
	dir = 1
	},
/obj/effect/decal/cleanable/blood/drip{
	dir = 1;
	icon_state = "pool1"
	},
/turf/open/floor/rogue/tile/brick,
/area/template_noop)
"y" = (
/obj/machinery/light/rogue/wallfire{
	pixel_y = 32
	},
/turf/open/floor/rogue/tile/brick,
/area/template_noop)
"z" = (
/obj/structure/chair/wood/rogue{
	dir = 8
	},
/turf/open/floor/rogue/tile/brick,
/area/template_noop)
"B" = (
/obj/structure/table/wood,
/obj/item/rogueweapon/huntingknife/idagger{
	pixel_y = 4
	},
/turf/open/floor/rogue/tile/brick,
/area/template_noop)
"D" = (
/turf/closed/wall/mineral/rogue/wooddark,
/area/template_noop)
"F" = (
/turf/closed/wall/mineral/rogue/wooddark/end,
/area/template_noop)
"N" = (
/turf/closed/wall/mineral/rogue/wooddark/horizontal,
/area/template_noop)
"P" = (
/obj/random/mob/skeleton,
/turf/open/floor/rogue/dirt/road,
/area/template_noop)
"Q" = (
/obj/effect/decal/cleanable/blood/drip{
	dir = 1;
	icon_state = "floor7-old"
	},
/turf/open/floor/rogue/dirt/road,
/area/template_noop)
"S" = (
/obj/item/dildo/gold{
	pixel_x = -7;
	pixel_y = -1
	},
/obj/machinery/light/rogue/torchholder/r,
/obj/effect/decal/cleanable/blood/drip{
	dir = 1;
	icon_state = "handblood"
	},
/turf/open/floor/rogue/tile/brick,
/area/template_noop)
"T" = (
/obj/structure/mineral_door/wood/deadbolt{
	dir = 8
	},
/turf/open/floor/rogue/tile/brick,
/area/template_noop)
"U" = (
/obj/effect/decal/cleanable/blood/drip{
	dir = 1;
	icon_state = "floor7-old"
	},
/turf/open/floor/rogue/tile/brick,
/area/template_noop)
"W" = (
/obj/item/dildo/gold{
	pixel_y = -1;
	pixel_x = 23
	},
/obj/effect/decal/cleanable/blood/drip{
	dir = 1;
	icon_state = "pool3"
	},
/turf/open/floor/rogue/tile/brick,
/area/template_noop)
"Y" = (
/obj/structure/rack/rogue/shelf/big{
	pixel_x = 31
	},
/obj/item/reagent_containers/glass/bottle/rogue/water{
	pixel_x = 28;
	pixel_y = 21
	},
/obj/effect/decal/cleanable/glass,
/turf/open/floor/rogue/tile/brick,
/area/template_noop)
"Z" = (
/obj/effect/decal/cleanable/blood/drip,
/turf/open/floor/rogue/tile/brick,
/area/template_noop)

(1,1,1) = {"
b
b
b
b
b
b
b
b
b
b
b
"}
(2,1,1) = {"
b
F
o
o
o
o
o
o
o
F
b
"}
(3,1,1) = {"
b
N
f
c
B
a
j
j
k
N
b
"}
(4,1,1) = {"
b
N
a
z
z
a
a
a
k
N
b
"}
(5,1,1) = {"
b
N
y
l
a
a
a
U
a
F
b
"}
(6,1,1) = {"
b
N
a
u
x
Z
Y
d
a
q
Q
"}
(7,1,1) = {"
b
N
T
D
F
o
o
o
o
F
b
"}
(8,1,1) = {"
b
N
a
W
N
b
b
b
b
b
b
"}
(9,1,1) = {"
b
N
S
n
N
b
P
b
b
b
b
"}
(10,1,1) = {"
b
F
D
D
F
b
b
b
b
b
b
"}
(11,1,1) = {"
b
b
b
b
b
b
b
b
b
b
b
"}
