//MAP CONVERTED BY dmm2tgm.py THIS HEADER COMMENT PREVENTS RECONVERSION, DO NOT REMOVE
"a" = (
/turf/open/water/cleanshallow,
/area/template_noop)
"b" = (
/obj/effect/decal/cleanable/dirt,
/obj/effect/decal/cleanable/dirt,
/obj/structure/flora/roguegrass/bush,
/turf/open/floor/rogue/dirt/road,
/area/template_noop)
"f" = (
/turf/open/floor/rogue/cobblerock,
/area/template_noop)
"g" = (
/obj/effect/decal/cleanable/dirt,
/obj/structure/flora/roguegrass/water/reeds,
/obj/structure/flora/roguegrass/maneater/real,
/turf/open/floor/rogue/grass,
/area/template_noop)
"i" = (
/obj/effect/decal/cleanable/dirt,
/obj/effect/decal/cleanable/dirt,
/obj/structure/flora/roguegrass/bush,
/turf/open/floor/rogue/grass,
/area/template_noop)
"k" = (
/obj/effect/decal/cleanable/dirt,
/obj/effect/decal/cleanable/dirt,
/turf/open/floor/rogue/dirt/road,
/area/template_noop)
"l" = (
/obj/effect/decal/cleanable/dirt,
/obj/structure/flora/roguegrass/bush,
/turf/open/floor/rogue/grass,
/area/template_noop)
"n" = (
/obj/effect/decal/cleanable/dirt,
/obj/structure/flora/roguegrass/bush,
/turf/open/floor/rogue/dirt/road,
/area/template_noop)
"p" = (
/obj/structure/flora/roguegrass/bush,
/turf/open/floor/rogue/dirt/road,
/area/template_noop)
"q" = (
/turf/open/floor/rogue/grass,
/area/template_noop)
"r" = (
/obj/effect/decal/cleanable/dirt,
/obj/effect/decal/cleanable/dirt,
/obj/structure/flora/roguegrass/water/reeds,
/turf/open/floor/rogue/dirt/road,
/area/template_noop)
"u" = (
/obj/effect/decal/cleanable/dirt,
/obj/effect/decal/cleanable/dirt,
/turf/open/floor/rogue/grass,
/area/template_noop)
"v" = (
/obj/effect/light_emitter,
/turf/open/water/cleanshallow,
/area/template_noop)
"x" = (
/obj/effect/decal/cleanable/dirt,
/turf/open/floor/rogue/cobblerock,
/area/template_noop)
"y" = (
/obj/effect/decal/cleanable/dirt,
/obj/effect/decal/cleanable/dirt,
/turf/closed/mineral/rogue,
/area/template_noop)
"C" = (
/turf/open/floor/rogue/dirt/road,
/area/template_noop)
"F" = (
/obj/effect/decal/cleanable/dirt,
/obj/effect/decal/cleanable/dirt,
/turf/open/floor/rogue/cobblerock,
/area/template_noop)
"G" = (
/obj/structure/flora/roguegrass,
/turf/open/floor/rogue/dirt/road,
/area/template_noop)
"H" = (
/obj/effect/decal/cleanable/dirt,
/turf/closed/mineral/rogue,
/area/template_noop)
"I" = (
/obj/effect/decal/cleanable/dirt,
/turf/open/floor/rogue/grass,
/area/template_noop)
"K" = (
/obj/effect/decal/cleanable/dirt,
/obj/structure/flora/roguegrass/water/reeds,
/turf/open/floor/rogue/dirt/road,
/area/template_noop)
"L" = (
/turf/closed/mineral/rogue,
/area/template_noop)
"M" = (
/obj/effect/decal/cleanable/dirt,
/turf/open/floor/rogue/dirt/road,
/area/template_noop)
"N" = (
/obj/effect/decal/cleanable/dirt,
/obj/effect/decal/cleanable/dirt,
/obj/structure/flora/roguegrass/water/reeds,
/turf/open/floor/rogue/grass,
/area/template_noop)
"P" = (
/obj/effect/decal/cleanable/dirt,
/obj/effect/decal/cleanable/dirt,
/obj/structure/flora/roguegrass/water/reeds,
/obj/structure/flora/roguegrass/maneater,
/turf/open/floor/rogue/dirt/road,
/area/template_noop)
"Q" = (
/obj/structure/flora/roguegrass/water/reeds,
/turf/open/water/cleanshallow,
/area/template_noop)
"S" = (
/obj/structure/flora/roguegrass/bush,
/turf/open/floor/rogue/grass,
/area/template_noop)
"U" = (
/obj/effect/decal/cleanable/dirt,
/obj/effect/decal/cleanable/dirt,
/obj/structure/flora/roguegrass/maneater/real,
/turf/open/floor/rogue/grass,
/area/template_noop)
"V" = (
/obj/structure/flora/roguegrass/water/reeds,
/obj/structure/flora/roguegrass/maneater,
/turf/open/floor/rogue/grass,
/area/template_noop)
"X" = (
/obj/structure/flora/roguegrass/water/reeds,
/obj/structure/flora/roguegrass/maneater/real,
/turf/open/floor/rogue/grass,
/area/template_noop)
"Y" = (
/obj/effect/decal/cleanable/dirt,
/obj/structure/flora/roguegrass/water/reeds,
/obj/structure/flora/roguegrass/maneater,
/turf/open/floor/rogue/grass,
/area/template_noop)
"Z" = (
/obj/effect/decal/cleanable/dirt,
/obj/structure/flora/roguegrass,
/turf/open/floor/rogue/grass,
/area/template_noop)

(1,1,1) = {"
x
x
f
M
M
C
M
C
f
f
x
"}
(2,1,1) = {"
x
L
C
H
I
G
M
C
Z
L
L
"}
(3,1,1) = {"
M
H
p
Z
q
i
I
X
V
I
H
"}
(4,1,1) = {"
f
C
q
N
Q
Q
a
a
a
S
f
"}
(5,1,1) = {"
C
G
Y
Q
Q
a
a
Q
Q
Z
C
"}
(6,1,1) = {"
M
k
g
a
a
v
a
Q
a
u
x
"}
(7,1,1) = {"
C
I
i
a
a
Q
Q
Q
U
u
x
"}
(8,1,1) = {"
C
M
Z
K
a
a
Q
a
l
q
G
"}
(9,1,1) = {"
f
H
u
q
q
P
r
u
I
L
C
"}
(10,1,1) = {"
F
b
M
k
q
Z
I
H
M
n
f
"}
(11,1,1) = {"
k
F
f
M
C
I
H
y
H
f
f
"}
